XXXXXXXXXXXXXXXXX
X         X     X
X XGXXX X X XXX X
X X X   X X   X X
XXXXXX XX X XXX X
X      G GX X X X
X XGXXX XXX X X X
X X             X
X X XXX XXXXXXX X
X   X     X   X X
X X XXX XXX XXX X
X   X     X     X
X X XXXXX XXX XXX
XPX X           X
X X XXX XXX XXX X
X             X X
XXXXXXXXXXXXXXXXX
